20 20
584 584
5 5 5 5 5 5 5 5 5 5 5 5 5 5 5 5 5 5 5 5
5 1 1 1 1 1 1 1 1 1 1 1 1 1 1 1 1 1 1 5
5 0 0 0 0 6 6 6 6 6 6 6 6 6 6 6 6 6 6 5
5 0 0 0 0 0 4 4 4 0 0 0 0 0 0 0 0 0 0 5
5 0 0 0 0 0 4 4 4 0 0 0 0 0 0 0 0 0 0 5
5 0 0 0 0 2 2 2 2 2 2 1 1 1 1 1 1 1 1 5
5 0 0 0 1 1 1 1 1 1 1 1 1 1 1 1 1 1 1 5
5 0 0 0 0 2 2 2 2 2 2 2 2 2 2 2 2 2 2 5
5 0 0 0 0 4 4 4 4 4 4 4 4 4 4 4 1 1 1 5
5 1 1 1 0 0 0 0 0 0 0 0 0 0 0 0 0 0 0 5
5 0 0 0 0 2 2 2 2 2 2 1 1 1 1 1 1 1 1 5
5 1 1 1 1 1 1 1 1 1 1 1 1 1 1 1 1 1 1 5
5 0 0 0 0 2 2 2 2 2 2 2 2 2 2 2 2 2 2 5
5 1 1 1 4 4 4 4 4 4 4 4 4 4 4 4 1 1 1 5
5 0 0 0 0 0 0 0 0 0 0 0 0 0 0 0 0 0 0 5
5 0 0 0 0 2 2 2 2 2 2 1 1 1 1 1 1 1 1 5
5 1 1 1 1 1 1 1 1 1 1 1 1 1 1 1 1 1 1 5
5 0 0 0 0 2 2 2 2 2 2 2 2 2 2 2 2 2 2 5
5 1 1 1 4 4 4 4 4 4 4 4 4 4 4 1 1 1 1 5
5 5 5 5 5 5 5 5 5 5 5 5 5 5 5 5 5 5 5 5
